antidiarrheal microorganisms	are	bacteria
antidiarrheal microorganisms	are	probiotics
antidiarrheal microorganisms	reduce	diarrhea
antidiarrheal microorganisms	inhibit	pathogenic bacteria
antidiarrheal microorganisms	compete	for nutrients
antidiarrheal microorganisms	produce	bacteriocins
bacteriocins	kill	Clostridioides difficile
bacteriocins	kill	Salmonella
antidiarrheal microorganisms	secrete	short-chain fatty acids
short-chain fatty acids	strengthen	gut barrier
gut barrier	prevents	bacterial translocation
antidiarrheal microorganisms	modulate	immune response
immune response	reduces	inflammation
inflammation	lowers	diarrhea severity
antidiarrheal microorganisms	colonize	small intestine
colonize	small intestine	improves	nutrient absorption
improved nutrient absorption	reduces	malnutrition
malnutrition	lowers	mortality
antidiarrheal microorganisms	are	Lactobacillus
antidiarrheal microorganisms	are	Bifidobacterium
Lactobacillus	produce	lactic acid
lactic acid	lowers	gut pH
low gut pH	inhibits	pathogenic growth
Bifidobacterium	produce	acetate
acetate	signals	gut motility
gut motility	normalizes	stool consistency
normal stool consistency	reduces	readmission
antidiarrheal microorganisms	are	Saccharomyces boulardii
Saccharomyces boulardii	inhibits	rotavirus
rotavirus	causes	watery diarrhea
watery diarrhea	increases	dehydration
dehydration	raises	mortality
antidiarrheal microorganisms	are	Bacillus subtilis
Bacillus subtilis	produce	subtilin
subtilin	kills	Vibrio cholerae
Vibrio cholerae	causes	cholera
cholera	leads to	electrolyte imbalance
electrolyte imbalance	treated by	rehydration
rehydration	improves	survival
antidiarrheal microorganisms	are	Enterococcus faecium
Enterococcus faecium	produce	enterocin
enterocin	inhibits	Shigella
Shigella	causes	dysentery
dysentery	increases	hospital stay
hospital stay	raises	cost
antidiarrheal microorganisms	are	Streptococcus thermophilus
Streptococcus thermophilus	ferment	lactose
ferment	produces	lactate
lactate	supports	gut flora
gut flora	maintains	microbiome diversity
microbiome diversity	predicts	resilience
resilience	reduces	recurrence
recurrence	lowers	readmission
antidiarrheal microorganisms	are	Pediococcus acidilactici
Pediococcus acidilactici	produce	pediocin
pediocin	targets	Listeria monocytogenes
Listeria monocytogenes	causes	foodborne illness
foodborne illness	leads to	diarrhea
diarrhea	increases	antibiotic use
antibiotic use	causes	resistance
resistance	worsens	treatment outcomes
treatment outcomes	influence	mortality
antidiarrheal microorganisms	are	Lactococcus lactis
Lactococcus lactis	produce	nisin
nisin	inhibits	Staphylococcus aureus
Staphylococcus aureus	causes	enterotoxemia
enterotoxemia	results in	diarrhea
diarrhea	increases	ICU admission
ICU admission	raises	morbidity
morbidity	predicts	long-term complications
long-term complications	affect	quality of life
quality of life	measured by	patient-reported outcomes
patient-reported outcomes	guide	therapy choice
therapy choice	impacts	cost-effectiveness
cost-effectiveness	informs	policy
policy	determines	probiotic availability
probiotic availability	affects	prescription patterns
prescription patterns	influence	adherence
adherence	correlates with	treatment success
treatment success	reduces	mortality
antidiarrheal microorganisms	are	Clostridium butyricum
Clostridium butyricum	produce	butyrate
butyrate	nourishes	colonocytes
colonocytes	strengthen	mucosal integrity
mucosal integrity	prevents	pathogen invasion
pathogen invasion	leads to	sepsis
sepsis	increases	mortality
antidiarrheal microorganisms	are	Bacillus coagulans
Bacillus coagulans	produce	gamma-aminobutyric acid
gamma-aminobutyric acid	modulates	gut-brain axis
gut-brain axis	influences	stress response
stress response	affects	immune function
immune function	determines	infection risk
infection risk	predicts	hospitalization
hospitalization	associated with	readmission
readmission	increases	healthcare burden
healthcare burden	drives	resource allocation
resource allocation	shapes	clinical guidelines
clinical guidelines	recommend	probiotic therapy
probiotic therapy	improves	patient outcomes
