alimentary tract	contains	digestive enzymes
digestive enzymes	break	food molecules
food molecules	provide	nutrients
nutrients	support	metabolic pathways
metabolic pathways	produce	energy
energy	fuels	cellular processes
cellular processes	regulate	hormone secretion
hormone secretion	modulate	appetite
appetite	influences	caloric intake
caloric intake	affects	body weight
body weight	predicts	cardiovascular risk
cardiovascular risk	increases	mortality
mortality	reduces	life expectancy
life expectancy	correlates	quality of life
quality of life	improves	patient satisfaction
patient satisfaction	lowers	readmission
readmission	indicates	disease severity
disease severity	guides	treatment choice
treatment choice	selects	drug therapy
drug therapy	targets	metabolic enzymes
metabolic enzymes	vary	genetic polymorphisms
genetic polymorphisms	affect	drug metabolism
drug metabolism	determines	drug efficacy
drug efficacy	influences	clinical outcome
clinical outcome	informs	prognosis
prognosis	predicts	survival
survival	depends on	comorbidities
comorbidities	include	diabetes
diabetes	causes	neuropathy
neuropathy	leads to	foot ulcers
foot ulcers	increase	infection risk
infection risk	raises	hospitalization
hospitalization	contributes to	healthcare cost
healthcare cost	drives	resource allocation
resource allocation	affects	treatment availability
treatment availability	determines	patient access
patient access	impacts	adherence
adherence	predicts	therapeutic success
therapeutic success	measured by	biomarker levels
biomarker levels	reflect	disease activity
disease activity	monitored by	imaging
imaging	detects	structural changes
structural changes	correlate	functional impairment
functional impairment	reduces	mobility
mobility	influences	fall risk
fall risk	increases	injury rate
injury rate	elevates	mortality
mortality	linked to	age
age	modifies	drug pharmacokinetics
drug pharmacokinetics	alter	dosing
dosing	affects	side effect profile
side effect profile	determines	drug discontinuation
drug discontinuation	leads to	disease flare
disease flare	requires	emergency care
emergency care	escalates	ICU admission
ICU admission	predicts	long-term disability
long-term disability	reduces	employment
employment	affects	socioeconomic status
socioeconomic status	influences	health literacy
health literacy	shapes	health behavior
health behavior	modulates	lifestyle disease
lifestyle disease	includes	hypertension
hypertension	treated with	antihypertensives
antihypertensives	interact with	other drugs
drug interactions	cause	adverse events
adverse events	trigger	monitoring
monitoring	identifies	subclinical toxicity
subclinical toxicity	prevents	organ failure
organ failure	results in	transplant
transplant	requires	immunosuppression
immunosuppression	increases	infection
infection	leads to	sepsis
sepsis	associated with	organ dysfunction
organ dysfunction	measured by	SOFA score
SOFA score	predicts	mortality
mortality	correlated with	ICU length of stay
ICU length of stay	impacts	hospital readmission
hospital readmission	signals	inadequate discharge planning
discharge planning	improves	continuity of care
continuity of care	reduces	readmission
readmission	indicates	care quality
care quality	reflected in	accreditation
accreditation	drives	quality improvement
quality improvement	enhances	patient safety
patient safety	lowers	adverse events
adverse events	decrease	life expectancy
life expectancy	influenced by	genetic factors
genetic factors	determine	disease susceptibility
disease susceptibility	informs	preventive screening
preventive screening	detects	early disease
early disease	improves	treatment outcomes
treatment outcomes	measured by	remission rate
remission rate	predicts	long-term survival
long-term survival	depends on	comorbidity burden
comorbidity burden	assessed by	Charlson index
Charlson index	guides	risk stratification
risk stratification	informs	clinical trial design
clinical trial design	selects	patient population
patient population	determines	drug approval
drug approval	ensures	therapeutic availability
