diagnostic radiopharmaceuticals	belong to	ATC
diagnostic radiopharmaceuticals	used for	imaging
diagnostic radiopharmaceuticals	contain	radioisotope
radioisotope	emits	gamma rays
gamma rays	detected by	gamma camera
gamma camera	produces	image
image	shows	organ function
organ function	indicates	disease
disease	requires	treatment
treatment	may involve	surgery
surgery	reduces	mortality
diagnostic radiopharmaceuticals	classified by	organ system
organ system	includes	heart
heart	imaged by	technetium‑99m sestamibi
technetium‑99m sestamibi	used for	myocardial perfusion
myocardial perfusion	assesses	ischemia
ischemia	predicts	cardiac events
cardiac events	increase	readmission risk
readmission risk	informs	discharge planning
discharge planning	improves	patient outcomes
diagnostic radiopharmaceuticals	include	iodine‑123
iodine‑123	used for	thyroid imaging
thyroid imaging	detects	nodules
nodules	may be	malignant
malignant nodules	require	biopsy
biopsy	guides	chemotherapy
chemotherapy	affects	survival
survival	inversely related to	tumor stage
tumor stage	determined by	imaging
imaging	performed with	positron emission tomography
positron emission tomography	uses	fluorodeoxyglucose
fluorodeoxyglucose	accumulates in	cancer cells
cancer cells	show	high glucose uptake
high glucose uptake	indicates	aggressive tumor
aggressive tumor	predicts	poor prognosis
poor prognosis	leads to	palliative care
palliative care	reduces	hospital stay
hospital stay	affects	cost
cost	influences	insurance coverage
insurance coverage	determines	medication adherence
medication adherence	affects	disease control
disease control	measured by	biomarker levels
biomarker levels	monitored with	blood tests
blood tests	scheduled after	imaging
imaging	scheduled before	surgery
surgery	requires	anesthesia
anesthesia	monitored by	anesthesiologist
anesthesiologist	records	vital signs
vital signs	tracked by	telemetry
telemetry	alerts	complications
complications	increase	ICU admission
ICU admission	predicts	mortality
mortality	reduced by	early detection
early detection	achieved with	screening
screening	uses	low‑dose CT
low‑dose CT	detects	lung nodules
lung nodules	evaluated by	PET/CT
PET/CT	combines	PET and CT
CT	provides	anatomical detail
anatomical detail	guides	surgical planning
surgical planning	improves	operative success
operative success	lowers	postoperative complications
postoperative complications	reduce	quality of life
quality of life	measured by	questionnaire
questionnaire	informs	rehabilitation
rehabilitation	enhances	functional status
functional status	predicts	readmission
readmission	associated with	comorbidities
comorbidities	identified by	EHR
EHR	stores	medication history
medication history	used for	drug interaction risk
drug interaction risk	alerts	prescriber
prescriber	adjusts	dosage
dosage	tailored to	renal function
renal function	assessed by	creatinine clearance
creatinine clearance	estimated with	Cockcroft–Gault
Cockcroft–Gault	informs	drug selection
drug selection	impacts	therapeutic index
therapeutic index	determines	safety margin
safety margin	reduces	adverse events
adverse events	lower	patient satisfaction
patient satisfaction	correlates with	adherence
adherence	improves	disease remission
disease remission	reduces	relapse
relapse	increases	imaging frequency
imaging frequency	affects	radiation dose
radiation dose	linked to	cancer risk
cancer risk	mitigated by	dose optimization
dose optimization	guided by	ALARA principle
ALARA principle	implemented in	imaging protocols
imaging protocols	reviewed by	radiologist
radiologist	reports	findings
findings	entered into	clinical decision support
clinical decision support	recommends	follow‑up
follow‑up	scheduled with	primary care
primary care	monitors	chronic disease
chronic disease	managed with	lifestyle changes
lifestyle changes	supported by	counseling
counseling	improves	health literacy
health literacy	predicts	health outcomes
