biliary tract disease	is a	medical condition
gallstones	cause	biliary obstruction
gallstones	cause	cholecystitis
choledocholithiasis	is a	biliary obstruction
choledocholithiasis	causes	biliary obstruction
biliary obstruction	leads to	jaundice
jaundice	is a	symptom
cholecystitis	is a	biliary tract inflammation
cholangitis	is a	biliary tract infection
biliary tract infection	may lead to	sepsis
gallbladder	stores	bile
bile duct	transports	bile
ultrasound	detects	gallstones
ultrasound	detects	biliary dilation
MRCP	visualizes	biliary tree
ERCP	is used for	stone extraction
ERCP	is used for	biliary drainage
laparoscopic cholecystectomy	is a	surgical procedure
open cholecystectomy	is a	surgical procedure
cholecystectomy	is a	surgical procedure
stent	is used for	biliary obstruction
biliary drainage	is a	procedure
antibiotics	are used to treat	cholangitis
ursodeoxycholic acid	is used for	dissolution of cholesterol stones
bilirubin	rises in	biliary obstruction
alkaline phosphatase	rises in	biliary obstruction
gamma-glutamyl transferase	rises in	biliary obstruction
liver function tests	assess	biliary disease
cholesterol gallstones	form in	bile
pigment stones	form in	bile
gallstone disease	is a	subset of biliary tract disease
biliary colic	is a	symptom
gallbladder	is an	organ
bile duct	is a	conduit
primary biliary cholangitis	is a	autoimmune liver disease
primary sclerosing cholangitis	is a	chronic biliary disease
cholangiocarcinoma	is a	biliary tract cancer
gallbladder cancer	is a	biliary tract cancer
primary sclerosing cholangitis	progresses to	cirrhosis
cholangiocarcinoma	risk factor includes	PSC
cholangitis	requires	antibiotics
post-cholecystectomy syndrome	is a	complication
stone recurrence	occurs after	cholecystectomy
obesity	increases risk of	cholesterol gallstones
female sex	increases risk of	cholesterol gallstones
pregnancy	increases risk of	gallstones
rapid weight loss	increases risk of	cholesterol gallstones
high cholesterol diet	increases risk of	cholesterol gallstones
age	is a risk factor for	biliary tract disease
diabetes	is a risk factor for	biliary tract disease
pancreatitis	may accompany	biliary obstruction
sepsis	can result from	cholangitis
readmission	associated with	biliary procedures
stone dissolution therapy	is a	treatment option
cholesterol stones	form in	bile
pigment stones	form in	bile
biliary colic	presents with	right upper quadrant pain
right upper quadrant pain	is a	symptom
fever	is a	sign of infection in biliary disease
elevated bilirubin	indicates	biliary obstruction
elevated alkaline phosphatase	indicates	biliary obstruction
elevated gamma-glutamyl transferase	indicates	biliary obstruction
MRCP	is used for	biliary anatomy assessment
CT scan	detects	biliary obstruction
liver biopsy	is used for	evaluation of liver disease
biliary dyskinesia	is a	biliary motility disorder
biliary tract	maintains	bile flow
cystic duct	connects to	common bile duct
cystic duct	is an	anatomical structure
common bile duct	obstructed by	stone
stone	causes	biliary obstruction
liver failure	may result from	biliary disease
antibiotic prophylaxis	used in	cholecystectomy
postoperative analgesia	required for	cholecystectomy
anesthesia	administered during	cholecystectomy
surgical drain	used after	cholecystectomy
endoscopic sphincterotomy	is a	procedure
balloon dilatation	is a	procedure
biliary stent	provides	drainage
biliary stenting	is a	procedure
ursodeoxycholic acid	is a	bile acid therapy
bile acid therapy	is a	treatment option
laparoscopy	is a	minimally invasive surgical approach
surgery	reduces	biliary pain
endoscopy	provides	diagnostic visualization
choledochoscope	is used for	stone extraction
bile duct	receives	bile from liver
ductal dilation	occurs in	biliary obstruction
obstructive jaundice	is a	manifestation of biliary obstruction
biliary sludge	can indicate	biliary stasis
biliary stasis	predisposes to	gallstone formation
stone formation	occurs in	gallbladder
gallbladder wall thickening	is a	finding in cholecystitis
stone impact	causes	biliary obstruction
systemic inflammation	accompanies	cholangitis
clinical outcome	depends on	timely treatment
timely treatment	improves	prognosis
prognosis	depends on	extent of obstruction
extent of obstruction	influences	treatment choice
treatment choice	determined by	stone location
