contraception	prevents	pregnancy
intrauterine device	prevents	pregnancy
copper intrauterine device	prevents	pregnancy
hormonal intrauterine device	prevents	pregnancy
oral contraceptive pill	suppresses	ovulation
combined oral contraceptive	suppresses	ovulation
progestin-only pill	suppresses	ovulation
implant	prevents	pregnancy
levonorgestrel implant	prevents	pregnancy
barrier method	reduces	pregnancy
condom	reduces	pregnancy
diaphragm	reduces	pregnancy
cervical cap	reduces	pregnancy
spermicide	used for	contraception
contraceptive patch	used for	contraception
contraceptive vaginal ring	used for	contraception
injectable contraception	used for	contraception
depot medroxyprogesterone acetate	used for	contraception
vasectomy	provides	permanent contraception
tubal ligation	provides	permanent contraception
female sterilization	provides	permanent contraception
emergency contraception	reduces	pregnancy
natural family planning	uses	cycle data
fertility awareness method	relies on	cycle tracking
preconception counseling	improves	pregnancy planning
family planning	improves	birth spacing
sterilization	provides	permanent contraception
fertility clinic	offers	fertility services
reproductive endocrinology	specializes in	infertility
assisted reproductive technology	used for	infertility
in vitro fertilization	used for	infertility
intracytoplasmic sperm injection	used for	infertility
ovulation induction	used for	infertility
intrauterine insemination	used for	infertility
donor sperm	used for	infertility
donor egg	used for	infertility
embryo transfer	component of	IVF
embryo cryopreservation	used for	fertility preservation
oocyte cryopreservation	used for	fertility preservation
preimplantation genetic testing	used for	fetal screening
prenatal care	improves	pregnancy outcomes
prenatal vitamins	taken for	pregnancy support
fetal ultrasound	used for	fetal assessment
genetic screening	performed for	pregnancy planning
preconception health	improves	fertility
contraceptive counseling	improves	adherence to contraception
breastfeeding	provides	natural contraception
lactational amenorrhea method	provides	contraception
postpartum contraception planning	guides	family planning
luteal phase	regulated by	progesterone
menstrual cycle	length relates to	fertility
menopause	ends	fertility
perimenopause	reduces	fertility
age	reduces	fertility
weight	influences	contraception effectiveness
drug interactions	reduce	contraception effectiveness
antibiotics	reduce	oral contraceptive effectiveness
rifampin	reduces	oral contraceptive effectiveness
antiretroviral therapy	interacts with	contraception
smoking	contraindicated in	estrogen-containing contraception
age	influences	contraceptive choice
blood pressure	monitored during	contraception use
thrombosis risk	increased by	estrogen-containing contraception
liver disease	contraindication for	estrogen-containing contraception
cardiovascular risk	affected by	contraception choice
pregnancy test	used for	confirm pregnancy
urine pregnancy test	used for	pregnancy confirmation
serum hCG	used for	pregnancy confirmation
birth plan	developed with	patient
prenatal screening	detects	fetal abnormalities
fetal anomaly	detected by	prenatal screening
ultrasound	used for	fetal development assessment
birth outcome	associated with	prenatal care
neonatal outcome	improved by	prenatal care
cesarean section	used for	delivery
vaginal delivery	preferred when	conditions permit
pregnancy	ends with	birth
preterm birth	risk increased by	maternal age
gestational age	estimated by	ultrasound
fetal growth restriction	associated with	maternal conditions
gestational diabetes	managed with	dietary therapy
hypertension	complicates	pregnancy
preeclampsia	risk factors include	nulliparity
beta-hCG	indicate	pregnancy viability
ectopic pregnancy	risk factors include	tubal damage
uterus	supports	pregnancy
placenta	provides	nutrients to fetus
amniotic fluid	surrounds	fetus
cord blood	contains	stem cells
clinical guideline	recommends	postpartum contraception
public health program	promotes	family planning
postpartum contraception	duration of effectiveness	depends on method
long-acting reversible contraception	reduces	unintended pregnancies
progestin-only methods	preferred in	lactation
estrogen-containing contraception	contraindicated in	breastfeeding within postpartum period
contraception adherence	essential for	effectiveness
counseling	improves	method uptake
fertility preservation	option for	gonadotoxic therapy
fertility decline	associated with	age
assisted reproduction outcomes	depend on	embryo quality
