spontaneous abortion	is a	pregnancy loss
spontaneous abortion	occurs in	first trimester
fetal chromosomal abnormality	is a	common cause of spontaneous abortion
chromosomal abnormality	is a	cause of spontaneous abortion
advanced maternal age	increases risk for	spontaneous abortion
smoking	increases risk for	spontaneous abortion
obesity	increases risk for	spontaneous abortion
diabetes mellitus	increases risk for	spontaneous abortion
hypertension	increases risk for	spontaneous abortion
uterine anomaly	is a	risk factor for spontaneous abortion
antiphospholipid syndrome	is associated with	spontaneous abortion
systemic lupus erythematosus	is associated with	spontaneous abortion
thrombophilia	associated with	spontaneous abortion
infection	associated with	spontaneous abortion
recurrent pregnancy loss	defined as	multiple spontaneous abortions
hCG	declines after	spontaneous abortion
vaginal bleeding	accompanies	spontaneous abortion
abdominal pain	accompanies	spontaneous abortion
cramping	accompanies	spontaneous abortion
fetal heartbeat	absent in	spontaneous abortion
ultrasound	detects	nonviable pregnancy
spontaneous abortion	diagnosed by	ultrasound
spontaneous abortion	managed with	expectant management
spontaneous abortion	managed with	medical management
spontaneous abortion	managed with	surgical evacuation
medical management	uses	misoprostol
misoprostol	used for	medical management
dilation and curettage	used for	surgical management
surgical evacuation	removes	products of conception
retained products of conception	can occur after	spontaneous abortion
retained products of conception	require	surgical removal
incomplete abortion	defined as	partial expulsion of products of conception
complete abortion	defined as	complete expulsion of products of conception
rh immunoglobulin	given after	spontaneous abortion in Rh-negative mother
Rh-negative mother	should receive	rh immunoglobulin after spontaneous abortion
spontaneous abortion	can lead to	emotional distress
psychological distress	occurs after	spontaneous abortion
counseling	provided after	spontaneous abortion
support	provided after	spontaneous abortion
time to conception	after spontaneous abortion	may be normal
fertility	returns after	spontaneous abortion
future pregnancy outcome	may be influenced by	prior spontaneous abortion
genetic counseling	offered after	spontaneous abortion
conception planning	discussed after	spontaneous abortion
thrombophilia screen	considered after	spontaneous abortion
thyroid disease	associated with	spontaneous abortion
autoimmune disease	associated with	spontaneous abortion
antibody testing	performed after	spontaneous abortion
product of conception	expelled in	complete abortion
placental tissue	expelled with	products of conception
uterine lining	regenerates after	spontaneous abortion
ovulation	resumes after	spontaneous abortion
menses	resumes after	spontaneous abortion
recurrent pregnancy loss	increases	future risk of	pregnancy loss
