postoperative care	includes	wound dressing
postoperative care	includes	pain management
postoperative care	includes	mobility guidance
wound dressing	requires	sterile technique
sterile technique	reduces	infection risk
infection risk	increases with	poor wound care
antibiotic prophylaxis	prevents	wound infection
antibiotic prophylaxis	used during	surgery
pain management	aims	analgesia
analgesia	provides	pain relief
nurse	administers	analgesia
nurse	monitors	wound healing
wound healing	assessed by	clinician
clinician	orders	follow-up appointment
follow-up appointment	scheduled after	surgery
surgery	requires	anesthesia
anesthesia	provides	unconsciousness
postoperative period	monitored by	nurse
postoperative period	ends with	discharge
discharge	includes	medication list
medication list	given at	discharge
home care instructions	include	wound care steps
wound care steps	include	dressing change schedule
dressing change schedule	requires	sterile gloves
sterile gloves	worn by	caregiver
caregiver	trains	patient
patient	adheres to	care plan
care plan	improves	outcomes
outcomes	correlate with	adherence
adherence	reduces	readmission risk
readmission risk	higher with	poor discharge planning
suture removal	occurs during	wound care
infection	diagnosed by	clinician
antibiotic therapy	prescribed for	infection
antibiotic therapy	has	side effects
GI upset	is a side effect of	antibiotic therapy
hydration	mitigates	GI upset
hydration	supports	wound healing
nutrition	influences	healing rate
healing rate	determines	return to activity
return to activity	depends on	rehabilitation program
rehabilitation program	includes	physical therapy
physical therapy	improves	mobility
mobility	enables	independence
smoking	impairs	wound healing
smoking cessation	improves	healing outcomes
diabetes	delays	wound healing
blood glucose control	improves	healing rate
insulin	used for	diabetes management
diabetes management	reduces	complication risk
complication risk	increases with	immobility
immobility	leads to	venous thromboembolism
early ambulation	reduces	venous thromboembolism
early ambulation	recommended after	surgery
pain score	tracked by	clinician
clinician	adjusts	analgesia
analgesia	has	dosing schedule
dosing schedule	printed on	medication label
medication label	lists	dosage
discharge summary	documents	instructions
instructions	cover	wound care
wound care	includes	dressing instructions
dressing instructions	specify	frequency
frequency	affects	healing
pain management	includes	acetaminophen
acetaminophen	used for	pain relief
NSAIDs	avoided after	orthopedic surgery
penicillin allergy	included in	medication profile
medication profile	reviewed by	clinician
clinician	updates	caregiver
caregiver	provides	home care support
home care support	reduces	hospital visits
hospital visits	replaced by	telemonitoring
telemonitoring	monitors	vital signs remotely
vital signs	include	heart rate
heart rate	monitored by	digital monitor
digital monitor	transmits	vitals data
vitals data	reviewed by	clinician
wound infection	diagnosed by	clinician
clot prevention	includes	compression therapy
compression therapy	reduces	swelling
swelling	indicates	inflammation
inflammation	increases	pain
pain	managed by	analgesic
analgesic	has	side effects
side effects	require	monitoring
monitoring	required after	surgery
surgery	followed by	rehab
rehab	follows	surgery
rehabilitation program	includes	therapeutic exercises
therapeutic exercises	improve	strength
strength	enables	return to work
return to work	depends on	functional recovery
functional recovery	guided by	therapist
therapist	evaluates	progress
progress	documented in	progress notes
progress notes	reviewed at	follow-up visit
follow-up visit	assesses	wound healing
wound healing	indicates	discharge readiness
discharge	occurs after	full recovery
