obesity	is a	metabolic disorder
obesity	increases risk for	type 2 diabetes mellitus
obesity	increases risk for	hypertension
obesity	increases risk for	dyslipidemia
metabolic syndrome	is associated with	insulin resistance
metabolic syndrome	increases risk for	cardiovascular disease
type 2 diabetes mellitus	is a	metabolic disorder
type 2 diabetes mellitus	causes	nephropathy
type 2 diabetes mellitus	causes	retinopathy
type 2 diabetes mellitus	causes	neuropathy
type 2 diabetes mellitus	increases risk for	cardiovascular disease
type 2 diabetes mellitus	treated with	metformin
type 2 diabetes mellitus	treated with	insulin
type 1 diabetes mellitus	is a	autoimmune disorder
type 1 diabetes mellitus	requires	insulin
insulin	is a	hormone
metformin	is a	drug
statin	is a	drug
dyslipidemia	is a	lipid disorder
LDL cholesterol	is a	biomarker
HDL cholesterol	is a	biomarker
triglyceride	is a	biomarker
non-alcoholic fatty liver disease	is a	metabolic liver disease
NAFLD	is associated with	obesity
NAFLD	is associated with	insulin resistance
cirrhosis	is a	liver disease
hypothyroidism	is a	endocrine disorder
hypothyroidism	causes	hyperlipidemia
hyperthyroidism	is a	endocrine disorder
thyroiditis	is an	autoimmune condition
goiter	is a	thyroid condition
Hashimoto thyroiditis	is an	autoimmune disease
levothyroxine	is a	drug
osteoporosis	is a	bone disease
osteopenia	is a	bone disease
calcium	is a	mineral
phosphate	is a	mineral
parathyroid hormone	is a	hormone
vitamin D deficiency	is a	deficiency
iron deficiency anemia	is a	anemia
ferritin	is a	biomarker
vitamin B12 deficiency	is a	deficiency
folate deficiency	is a	deficiency
anemia	is a	hematologic condition
iron	is a	mineral
magnesium	is a	mineral
electrolyte imbalance	is a	disorder
hyponatremia	is a	electrolyte abnormality
hyperkalemia	is a	electrolyte abnormality
hypokalemia	is a	electrolyte abnormality
metabolic acidosis	is a	metabolic disorder
lactic acidosis	is a	metabolic acidosis
metabolic alkalosis	is a	metabolic disorder
pancreatic insufficiency	is a	digestive disorder
adrenal insufficiency	is a	endocrine disorder
Cushing syndrome	is a	endocrine disorder
polycystic ovary syndrome	is a	endocrine disorder
gestational diabetes	is a	pregnancy complication
insulin resistance	is a	metabolic state
microalbuminuria	is a	biomarker
diabetic nephropathy	is a	kidney complication
chronic kidney disease	is a	kidney disease
myocardial infarction	is a	cardiovascular event
stroke	is a	cardiovascular event
peripheral arterial disease	is a	cardiovascular complication
atherosclerosis	is a	cardiovascular disease
foot ulcer	is a	complication
infection	is a	complication
glycemic control	is a	metric
fasting glucose	is a	biomarker
C-peptide	is a	biomarker
HbA1c	is a	biomarker
bilirubin	is a	biomarker
alanine aminotransferase	is a	biomarker
aspartate aminotransferase	is a	biomarker
thyroid antibodies	is a	biomarker
thyroid peroxidase antibodies	is a	biomarker
fasting insulin	is a	biomarker
weight	is a	metric
age	is a	demographic factor
smoking	is a	risk factor
alcohol use	is a	risk factor
physical activity	is a	behavior
ACE inhibitor	is a	drug
angiotensin receptor blocker	is a	drug
albuminuria	is a	biomarker
glycemic index	is a	metric
glucose	is a	biomarker
glycemic variability	is a	metabolic parameter
cortisol	is a	hormone
aldosterone	is a	hormone
vitamin K deficiency	is a	deficiency
selenium deficiency	is a	deficiency
zinc deficiency	is a	deficiency
protein-energy malnutrition	is a	malnutrition
sleep apnea	is associated with	obesity
menopause	is associated with	osteoporosis
vitamin A deficiency	is a	deficiency
thiamine deficiency	is a	deficiency
niacin deficiency	is a	deficiency
